registerpage.new_password	registerpage.new_password
registerpage.notifyreply	registerpage.notifyreply
registerpage.allowbbcode	registerpage.allowbbcode
registerpage.reset	registerpage.reset
registerpage.msn	registerpage.msn	
registerpage.password_confirm	registerpage.password_confirm
registerpage.allowsmilies	registerpage.allowsmilies
registerpage.icq	registerpage.icq
registerpage.viewemail	registerpage.viewemail
registerpage.submit	registerpage.submit
registerpage.website	registerpage.website
registerpage.hideonline	registerpage.hideonline
registerpage.popup_pm	registerpage.popup_pm
registerpage.occupation	registerpage.occupation
registerpage.yim	registerpage.yim
registerpage.attachsig	registerpage.attachsig
registerpage.notifypm	registerpage.notifypm
registerpage.aim	registerpage.aim
registerpage.location	registerpage.location
registerpage.allowhtml	registerpage.allowhtml
registerpage.signature	registerpage.signature
registerpage.timezone	registerpage.timezone
registerpage.username	registerpage.username
registerpage.email	registerpage.email
registerpage.interests	registerpage.interests