profile.hideonline	profile.hideonline
profile.yim	profile.yim
profile.location	profile.location
profile.allowsmilies	profile.allowsmilies
profile.new_password	profile.new_password
profile.icq	profile.icq
profile.interests	profile.interests
profile.submit	profile.submit
profile.website	profile.website
profile.occupation	profile.occupation
profile.password_confirm	profile.password_confirm
profile.style	profile.style
profile.reset	profile.reset
profile.email	profile.email
profile.allowbbcode	profile.allowbbcode
profile.language	profile.language
profile.viewemail	profile.viewemail
profile.signature	profile.signature
profile.username	profile.username
profile.timezone	profile.timezone
profile.dateformat	profile.dateformat
profile.notifyreply	profile.notifyreply
profile.popup_pm	profile.popup_pm
profile.allowhtml	profile.allowhtml
profile.aim	profile.aim
profile.attachsig	profile.attachsig
profile.msn	profile.msn
profile.notifypm	profile.notifypm